R 800 600
NO ./textures/blue.xpm
SO ./textures/brick.xpm
WE ./textures/grey.xpm
EA ./textures/wood.xpm
SP ./textures/barrel.xpm
SPP ./textures/pillar.xpm
F 102,51,0
C 64,64,64

111111111111111111111
100000000300000000001
100000120000000020001
100000100000111111111
100002100300000000001
100000100000111110011
100000100000000000011
100000011110000203001
101110111110000000001
101110111110000N00001
111111111111111111111
