R 800 600
NO ./textures/wall_n.xpm
SO ./textures/wall_s.xpm
WE ./textures/wall_w.xpm
EA ./textures/wall_e.xpm
S ./textures/barrel.xpm
F 2,234,243
C 245,0,150

111111111111111111111
100000000000000000001
100000120000000020001
100000100000111111111
100002100000000000001
100000100000111110011
100000100000000000011
100000011110000200001
101110111110000000001
101110111110000N00001
111111111111111111111
