R 800 600
NO ./textures/blue.xpm
SO ./textures/brick.xpm
WE ./textures/grey.xpm
EA ./textures/wood.xpm
S ./textures/barrel.xpm

F 102,51,0
C 64,64,64

11111111111111111111
10000000000000000021
10000000000200000111
11111000000000000021
11000000002000000001
10000000000000000001
10000000000000N00001
10110000001000000001
111 111111 111111111
