R	800	400
NO	textures/wall_1.xpm
SO	textures/wall_2.xpm
WE	textures/wall_3.xpm
EA	textures/wall_4.xpm
S	textures/sprite_1.xpm

F	184, 113, 39
C	51, 198, 227

		1111111111111111111111111
		1000000000110000000000001
		1011000001110000002000001
		1001000000000000000000001
111111111011000001110000000000001
100000000011000001111111111111111
11110111111111011100000000001
11110111111111011101010010201
11000000110101011100000010001
10002000000000001100000010201
10000000000000000001010010001
11000001110101011111011110N0111
1111011111110101 101111010001
11111111 1111111 111111111111
