R	800 400
NO	./textures/wall_n.xpm
SO	./textures/wall_s.xpm
WE	./textures/wall_w.xpm
EA	./textures/wall_e.xpm
SP	./textures/barrel.xpm
F	184, 113, 39
C	51, 198, 227

111111111111111111111
100000000000000000001
100000120000000020001
100000100000111111111
100002100000000000001
100000100000111110011
100000100000000200011
100000011110000000001
101110111 10000000001
101 10111 10000N00001
111 11111 11111111111
