1111111111111111111111
10010000000C000C000001
100001111100000000C001
1P0011E0000000C0000001
1111111111111111111111
