1111111111111111111111
10010000000C000C000001
100001111100000000C001
1P0011E0000000C0000001
10010001000C00000C0001
10000000C0000000000001
10C1000C00110001000001
10000C00000C000C000001
1111111111111111111111
